R 10000 500
NO ./textures/north.xpm
SO ./textures/south.xpm
WE ./textures/west.xpm
EA ./textures/east.xpm
S ./sprite/sprite1.xpm
F 220    ,  100,0  
C 225,30,0

      11111111
      10000001
      10000N01
      10000001
11111110020001
10000000000001
10000000000001
10002000000201
10000000011111
1000000001
1111111111