R 1920     1080
NO ./textures/north.xpm
SO ./textures/north.xpm
WE ./textures/north.xpm
EA ./textures/north.xpm
S ./textures/north.xpm
F 220    ,  100,0  
C 225,30,0

1123
1008
1001
1111