R 1920     1080
NO ./textures/north.xpm
SO ./textures/north.xpm
WE ./textures/north.xpm
EA ./textures/north.xpm
S ./textures/north.xpm
F 220    ,  100,0  
C 225,30,0

      11111111
      10000001
      10000N01
      10000001
11111110000001
10000000000001
10000000000001
10000000000001
10000000011111
1000000001
1111111111