111111111111111
100000000000001
100000000002001
100000000000001
100020010000001
100000000000001
100000000000001
100000000000001
111111111111111